
Source: Longman 3000 list

The purpose of these translations is to verify that a wide variety of English words can be translated into BreadSpeak.

Please note that these translations are NOT part of the official BreadSpeak specification. This list may contain clerical errors.

(~) means that the gloss is the same as the original English.

A: Se (~)
Abandon: Tute tidi (Leave forever)
Ability: Va sake deka (Thing which can be done)
Able: Sake (~)
About: Zedu (~)
Above: Paga (~)
Abroad: Puki (Far away)
Absence: Da tu sasa (State of not existing)
Absolute: Saki (Certain)
Absorb: Sata dagi (Become a part of)
Abuse: Kive deke (Behave unkind toward)
Academic: Do kati (Pertaining to research)
Accept: Kape da gaga (Think to be acceptable)
Access: Gezu (~)
Accident: Gapo (~)
Accommodation: Gaka pase (Helpful condition)
Accompany: Zegi (Be with)
According to: Teda (Following)
Account: Peka kaka (Personal information)
Accurate: Ta (~)
Accuse: Kadu da gugi (Claim bad behavior)
Achieve: Safo (~)
Acid: Vevo (~)
Acknowledge: Kadu da sasa (State the existence of)
Acquire: Zevo (~)
Across: Paka (~)
Act: Deke (~)
Action: Detu (~)
Active: Zadi (~)
Activity: Vo deka (~)
Actor: Fo deke (One who acts)
Actual: Ta (~)
Ad: Vazo vo kavi (Company announcement)
Adapt: Kefi gako do defi (Change to endure)
Add: Teko (~)
Address: Papo Kaka (Position information)
Adequate: Gaga (~)
Adjust: Kefi seku (Change amount)
Administration: Fa zegu vako (Controlling group)
Admire: Feta detu (Appreciate an action)
Admit: Vegi do tezu (Allow to enter)
Adopt: Sati zepa (Start to own)
Adult: Peto (~)
Advance: Pafo te (Go forward)
Advantage: Sake da gagi deka (Ability to perform better)
Advertise: Kavi (~)
Advice: Vapi (~)
Affair: Seko satu (Happenings)
Affect: Dedu (~)
Afford: Sake vavo (Able to buy)
Affraid: Feka (~)
After: Taso (~)
Afternoon: Taso tabi pazo (After the middle of the day)
Again: Seve (~)
Against: Guko (~)
Age: Do tuza seku (Amount of oldness)
Agency: Da sake vako (Ability to control)
Agent: Fo deka (Someone who does something)
Aggressive: Gapa do vapu (Wanting to fight)
Ago: Tuso (Before)
Agree: Kafi (~)
Agriculture: Pepa do ka zese (System for creating plants)
Ahead: Pago (~)
Aid: Gave (~)
Aim: Keba pado (Fix direction)
Air: Vezo (~)
Aircraft: Vezo zaso (Air vehicle)
Airline: Vezo do te zese (Air travel system)
Airport: Vezo zaso zazu (Air vehicle building)
Alarm: Kavi (~)
Album: Fesa zegu (Group of music)
Alcohol: Fapo (~)
Alive: Pepi (~)
All: Seda (~)
Allow: Vagi (~)
Allowance: Vagi vape (Allowed money)
Almost: Degi (~)
Alone: Sedo (~)
Along: Paki (~)
Already: Tazi (~)
Also: Sevi (~)
Alter: Kefi (~)
Alternative: Sugi deku fo segu (Different than normal)
Although: Zesa (~)
Altogether: Pake (~)
Always: Seda tata (During all times)
Amazing: Gagi (~)
Ambition: Gapa do vadi (Wanting to work)
Ambulance: Do keba zaso (Healing vehicle)
Among: Papi (~)
Amount: Seku (~)
Analyze: Kake (~)
Ancient: Zu tuza (Very old)
And: Ga (~)
Anger: Do feda (~)
Angle: Pado (~)
Animal: Pepe (~)
Announce: Kavi (~)
Annoy: Fepu (~)
Annual: Seto tata pi tadu (Once per year)
Another: Sugi (~)
Answer: Kasi (~)
Anticipate: Kaba (~)
Anxiety: Do fepi (~)
Any: Sagu (~)
Apart: Puke (~)
Apartment: Sezu pagi zazu (Many home building)
Apologize: Kadu do fetu (Say that you are sorry)
Apparent: Sake beki (Able to be seen)
Appeal: Feta (~)
Appear: Sati pi do befe (Come into sight)
Appearance: Zaka (~)
Apple: Besa fasi (Red fruit)
Application: Zaki (~)
Apply: Teko pabi (Put on)
Appoint: Zeve vado (Give a job)
Appointment: Do zefe tata (Meeting time)
Appreciate: Feta (~)
Approach: Tedi (~)
Appropriate: Gaga (~)
Approval: Do kafi (~)
Approximate: Suki (~)
Architect: Ka gagu (Create design)
Area: Geka (~)
Argue: Kafa (~)
Arise: Sati pi do befe (Come into sight)
Arm: Dagu (~)
Army: Fo vapu zegu (Group of fighters)
Around: Paki (~)
Arrange: Zeka (~)
Arrest: Zeve guvo (Give punishment)
Arrive: Tedi (~)
Art: Febo (~)
Article: Dagi (Part)
Artificial: Pipu (~)
As: Deki (~)
Ashamed: Fetu (~)
Aside: Paki (~)
Ask: Kazi (~)
Asleep: Pevu (~)
Aspect: Dagi (Part)
Assess: Kati keke (Study the quality of)
Assignment: Gago (~)
Assist: Gave (~)
Associate: Kape da zede (Think to be related to)
Assume: Kaba (~)
Assure: Ka da fipi (Cause to be calm)
At: Pi (~)
Atmosphere: Vezo (~)
Attach: Gepa (~)
Attack: Vapu (~)
Attempt: Gatu (~)
Attend: Sasa pi (Be at)
Attention: Do kata (~)
Attitude: Do deke keke (Quality of behavior)
Attorney: Vaka peka (Law person)
Attract: Bude di (Pull toward)
Attractive: Kefo (~)
Audience: Fo befo (Watchers)
Aunt: Zefo zefa (Parent's sibling)
Author: Fo zabi (Writer)
Authority: Vase (~)
Automatic: Vadi keko ge (Work by itself)
Autumn: Sati kida du tado (Season of becoming cold)
Available: Sake tiko (Able to be taken)
Average: Segu (~)
Avoid: Kupu (~)
Awake: Pivu (~)
Award: Gavo (~)
Aware: Kapa (~)
Away: Puki (~)
Awful: Zu gugi (Very bad)
Awkward: Guka (Unhelpful)
Baby: Pete (~)
Back: Pako (~)
Background: Pase pugo (Environment behind)
Backwards: Pufo (~)
Bacon: Pego fape (Pig meat)
Bad: Gugi (~)
Bag: Zasu (~)
Bake: Fada (~)
Balance: Babo papo (Weight position)
Ball: Gego (~)
Ban: Tu vagi (Not allow)
Band: Zafe (~)
Bang: Do bafo bezo (Explosion noise)
Bank: Vape zazu (Money building)
Bar: Dafi (~)
Barrier: Fa sabo safi (Stopping object)
Base: Gifa (~)
Baseball: Do baka feba (Striking sport)
Basic: Kebi (~)
Basis: Fa kaka bapo (Supporting idea)
Basket: Zabo (~)
Bat: Tubi tepe peda (Flying night mammal)
Bath: Zabu (~)
Bathroom: Zabu dazu (Toilet room)
Battery: Badi zapi (Power container)
Battle: Vapu (~)
Be: Sa (~)
Beach: Dapi gezi (Ocean border)
Bean: Pedi (~)
Bear: Defi (~)
Beard: Daze pufa dada (Low facial hair)
Beat: Baka (~)
Beautiful: Kefo (~)
Because: Ka (~)
Become: Sata (~)
Bed: Do pevu zaga (Sleeping furniture)
Beef: Pegu fape (Cow meat)
Beer: Fave fapo (Wheat alcohol)
Before: Tuso (~)
Begin: Safi (~)
Behalf: Zepo (~)
Behave: Deke (~)
Behind: Pugo (~)
Belief: Vo kape (~)
Bell: Do kavi bezo zato (Alert noise tool)
Belong: Vatu pi (Should be in)
Below: Puga (~)
Belt: Zafe (~)
Bench: Do geva zaga (Sitting furniture)
Bend: Bado (~)
Beneath: Puga (~)
Benefit: Gagi vo ka (Good effect)
Beside: Paki (~)
Best: Deda gagi (Most good)
Bet: Vave keko saku (Pay with risk)
Better: Deko gagi (More good)
Between: Papi (~)
Beyond: Pago (~)
Bicycle: Date zaso (Foot vehicle)
Bid: Gatu da deda vave (Try to pay the most)
Big: Zu (~)
Bill: Fa vepa vapa vape (Requesting money paper)
Bin: Zabo (~)
Bird: Pebe (~)
Birth: Da ka pepe (Animal creation)
Biscuit: Fade (Bread)
Bit: Za dagi (Small part)
Bite: Fati (~)
Bitter: Beba (~)
Black: Bega (~)
Blade: Fa geke bati (Cutting edge)
Blame: Kadu da gugi deka (Claim someone to have done something bad)
Blank: Zuda (Empty)
Bless: Kafi keko vaza (Praise by religion)
Blind: Suke befe (Unable to see)
Block: Gegu (~)
Blonde: Bete dada (Yellow hair)
Blood: Vesa (~)
Blow: Bade vezo (Push air)
Blue: Bedo (~)
Board: Gebe zato (Flat tool)
Boat: Vedo zaso (Water vehicle)
Body: Pebo (~)
Boil: Sata vepe (Become a gas)
Bomb: Do bafo zato (Explosion device)
Bone: Veko (~)
Bonus: Gavo (~)
Book: Zapa (~)
Boom: Do bafo bezo (Explosion sound)
Boot: Vebu date zaza (Rubber foot clothing)
Border: Gezi (~)
Bored: Fifo (~)
Born: Peva (~)
Borrow: Tate zepa (Own temporarily)
Boss: Vo vako (~)
Both: Ga (~)
Bother: Fepu (~)
Bottle: Vepi zapi (Liquid container)
Bottom: Gifa (~)
Bounce: Tebu (~)
Bound: Sezi (~)
Bowl: Zabo (~)
Box: Gegu (~)
Boy: Pezu peta (Male child)
Brain: Fa daga kake (Thinking organ)
Branch: Dagu (~)
Brave: Kede (~)
Bread: Bread (~)
Break: Gedi (~)
Breakfast: Tabi zeti fadi (Start of day food)
Breast: Fage daga (Milk organ)
Breath: Vo pezo (~)
Breathe: Pezo (~)
Brick: Vete gegu (Ceramic block)
Bridge: Pafa zaze (High road)
Brief: Tapi za tata (During a short time)
Bright: Bezu (~)
Brilliant: Keka (~)
Bring: Tepa (~)
Broad: Gefe (~)
Brother: Pezu zefa (Male sibling)
Brown: Bizu beta (Dark orange)
Brush: Bada (~)
Bucket: Zabo (~)
Buddy: Zepi (~)
Budget: Do vave vape seku (Amount of money for spending)
Bug: Pesa (Arthropod)
Build: Ka (~)
Building: Zazu (~)
Bump: Gefu (~)
Bunch: Fo sezu (~)
Burn: Veda fato (Be eaten by fire)
Burst: Bafo (~)
Bury: Teko pi dadu (Put into the ground)
Bus: Sezu peka gi zaze zaso (Many person road vehicle)
Business: Vazo (~)
Busy: Vada (~)
But: Zesa (~)
Butter: Fage vefo (Milk fat)
Button: Dabe (~)
Buy: Vavo (~)
By: Keko (~)
Bye: Kufe (~)
Cabinet: Do pasu zaga (Storage furniture)
Cable: Zafi (~)
Cake: Fagi fade (Dessert bread)
Calculate: Kake (~)
Calendar: Tada gagu (Month plan)
Call: Kavo (~)
Calm: Fipi (~)
Camera: Fa zase befe (Seeing machine)
Camp: Saki gasa dadu (Land with a particular purpose)
Campaign: Detu gagu (Plan of action)
Can: Sake (~)
Cancel: Sufi (~)
Cancer: Sako dasa do pigi (Cell replication disease)
Candidate: Va sake gage (Thing which can be chosen)
Candle: Veda bebi (Fire light)
Candy: Fagi (~)
Cap: Fa zapu gefa (Top cover)
Capable: Sake (~)
Capital: Zezu (~)
Captain: Fo vapi (~)
Capture: Vake (~)
Car: Zaze zaso (Road vehicle)
Card: Za vepa (Small paper)
Care: Fepa (~)
Career: Vado (~)
Careful: Kepa (~)
Carpet: Davu veza (Floor cloth)
Carrot: Gefi ga beta fapa (Long orange vegetable)
Carry: Tepa (~)
Cartoon: Va zabi zaku (Drawn video)
Case: Zapi (~)
Cash: Vape sabo (Money object)
Cast: Teko vepi so pi gega gete (Put liquid into a shape hole)
Castle: (Attack building)
Cat: Peke (~)
Catalogue: Do vavo sabo zapa (Book of things for buying)
Catch: Bufa (~)
Category: Kegu (~)
Cause: Ka (~)
Cease: Suti (~)
Ceiling: Dazu gefa (Room top)
Celebrate: Fegu (~)
Cell: Dasa (~)
Cellphone: Zape zasa (Wireless phone)
Central: Pazo (~)
Cereal: Fava fadi (Grain food)
Certain: Kaki (~)
Certificate: Vase do kafi (Authority verification)
Chain: Do gepa zafi (Link string)
Chair: Do geva zaga (Sitting furniture)
Challenge: Kibi gago (Difficult task)
Champion: Deda gagi fo gati (Best winner)
Chance: Saku (~)
Change: Keti (~)
Channel: Tega (~)
Chapter: Zapa dagi (Part of a book)
Character: Zava (~)
Characteristic: Keke (~)
Charge: Zeve badi (Give power)
Charity: Vage zeve du vazo (Company for giving freely)
Chart: Do kako zaka (Representation drawing)
Chase: Gatu da teta gezu (Try to reach quickly)
Chat: Kadu (~)
Cheap: Za vapo (Small cost)
Cheat: Tu teda vaka (Not follow the rules)
Check: Befo keta (Look at the status of)
Cheek: Davo gezo (Mouth side)
Cheese: Fagu (~)
Chemical: Daza zeze (Configuration of atoms)
Cherry: Za ga besa fasi (Small red fruit)
Chest: Dazo gefa (Top of torso)
Chicken: Peba (~)
Chief: Zezu (~)
Child: Peta (~)
Chip: Gebe dagi (Flat piece)
Chocolate: Fazi beba gavo (Bitter sugar treat)
Choose: Gage (~)
Chop: Bati (~)
Chuck: Bafa (~)
Church: Vaza zazu (Religion building)
Cigarette: Vege dage (Smoke stick)
Cinema: Zaku zazu (Movie building)
Circle: Geso (~)
Circuit: Bapa tega (Electricity path)
Circumstance: Pase (~)
Citizen: Peka zepa pagi pi (Person having a home in a place)
City: Vagu (~)
Civil: Peka zegu (Pertaining to a group of people)
Claim: Kadu (~)
Class: Do kate tata (Education time)
Classic: Tuza keke (Having old qualities)
Clean: Kedu (~)
Clear: Vefe (~)
Clever: Keka (~)
Click: Beka (~)
Client: Vo gave (Person being helped)
Climate: Kepe (~)
Climb: Pafa te pabi (Go up a side)
Clock: Tata zato (Time device)
Close: Paki (~)
Closet: Do pasu dazu (Storage room)
Cloth: Veza (~)
Clothes: Zaza (~)
Cloud: Vege (~)
Club: Peka zegu (Group of people)
Clue: Fa gave do kadi (Aid for understanding)
Coach: Fo vapi (~)
Coal: Kidu bega veta (Dirty black rock)
Coast: Dadu geke (Edge of land)
Coat: Keda zaza (Warm clothing)
Code: Zaki (~)
Coffee: Faba (~)
Coin: Veto gi vape geso (Metal money circle)
Cold: Kida (~)
Collapse: Tebo (~)
Collar: Dagu zafe (Neck band)
Colleague: Sagi vazo fo vadi (Worker in the same company)
Collect: Pake teko (Put together)
College: Deko pafa do kate (Higher education)
Color: Bebe (~)
Column: Pavi zegu (Vertical group)
Combine: Pake teko (Put together)
Come: Tedi (~)
Comfortable: Fega (~)
Command: Vapa (~)
Comment: Kadu (~)
Commercial: Zaku do kavi (Video advertisement)
Commission: Vave vadi (Payed work)
Commit: Gage (~)
Committee: Vase (~)
Common: Segu (~)
Communicate: Kadu (~)
Community: Peka zegu (Group of people)
Company: Vazo (~)
Compare: Kata do sugi (Focus on differences)
Compete: Vapu (~)
Complain: Kadu gaku (Talk about problems)
Complete: Deto (~)
Complex: Kibi (~)
Component: Dagi (~)
Comprehensive: Deto (~)
Comprise: Sa dagi (Be a part of)
Computer: Zake (~)
Concentrate: Kata (~)
Concept: Kaka (~)
Concern: Fepa (~)
Concert: Fesa tata (Music time)
Conclude: Safo (~)
Condition: Pase (~)
Conduct: Vapi (~)
Conference: Do zefe (~)
Confident: Kede (~)
Confine: Pasu pi gepe (Keep in a space)
Confirm: Kafi (~)
Conflict: Gaku (~)
Confuse: Ka da kudi (Cause to misunderstand)
Congratulate: Kadu gagi do vadi (Say that someone did well)
Connect: Gepa (~)
Conscious: Pivu (~)
Consent: Kafi (~)
Consequence: Vo ka (Something that is caused)
Consider: Kake vo gage (Think about an option)
Consist: Veku (~)
Consistent: Sezu zepa seto keke (Often having a single quality)
Constant: Tu suti (Never stopping)
Constitute: Sa dagi (Be a part of)
Construct: Ka (~)
Consult: Zevo vo vapi de (Get advice from)
Consumer: Fo gato (~)
Contact: Babi (~)
Contain: Zepa pi (Have inside)
Contemporary: Taza keke (Having new qualities)
Content: Fegi (~)
Contest: Do vapu (~)
Context: Pase (~)
Continue: Tabe (~)
Contract: Da zabi kafi (Agreement in writing)
Contrast: Do sugi (~)
Contribute: Zeve (~)
Control: Vako (~)
Convenient: Gaka (~)
Convention: Segu ketu (Normal method)
Conversation: Do kadu (~)
Convert: Kefi (~)
Conviction: Do kede (~)
Convince: Ka da kape (Cause to believe)
Cook: Fada (~)
Cookie: Geso fagi (Circle treat)
Cool: Kevi (~)
Cooperate: Pake vadi (Work together)
Cope: Defi (~)
Copy: Sako (~)
Core: Pazo dagi (Center part)
Corn: Fate (~)
Corner: Geki (~)
Correct: Ta (~)
Corridor: Gefi dazu (Long room)
Cost: Vapo (~)
Cotton: Vese (~)
Could: Sadu sake (Would be able)
Council: Vase (~)
Count: Kapo seku (Measure the quantity of)
Country: Vadu (~)
Couple: Seta (~)
Courage: Kede (~)
Course: Tega (~)
Court: Vaka dazu (Law room)
Cousin: Zefo zefa zifo (Parent's sibling's offspring)
Cover: Zapu (~)
Cow: Pegu (~)
Crack: Gedi (~)
Craft: Ka (~)
Crash: Baka (~)
Crazy: Kedi (~)
Create: Ka (~)
Creative: Keza (~)
Creature: Pepe (~)
Credit: Detu do kafi (Confirmation of an action)
Crew: Fo vadi zegu (Group of workers)
Crime: Detu guko vaka (Action against the law)
Crisis: Gaku (~)
Criterion: Vo gaba (Requirement for)
Criticize: Beko gaku (Show the problems of)
Crop: Pepa fadi (Plant food)
Cross: Te paka (Go across)
Crowd: Peka zegu (Group of people)
Crown: Gake veto gi daku zaza (Valuable metal head clothing)
Crucial: Gake (~)
Cruel: Kive (~)
Cry: Ka dafe vedo (Produce water from eyes)
Culture: Keva (~)
Cup: Zabo (~)
Cupboard: Do pasu zaga (Storage furniture)
Curious: Gapa do kati (Wanting to learn)
Currency: Vape (~)
Current: Zi (~)
Curtain: Dabi veza (Window cloth)
Curve: Gebo (~)
Cushion: Zaga fega zasu (Comfortable furniture bag)
Custom: Sigu gage (Specially chosen)
Customer: Fo vavo (~)
Cut: Bati (~)
Cute: Kesi (~)
Cycle: Sako satu (Repeating events)
Dad: Pezu zefo (Male parent)
Daily: Seda tadi (Every day)
Damage: Kiba (~)
Dance: Tepo pebo so keko fesa (Move body with music)
Danger: Do kibe (~)
Dare: Dego kede (Be brave enough)
Dark: Bizu (~)
Darling: Feta (Loved)
Data: Kaka (~)
Database: Fa pasu kaka (Data storage)
Date: Tadu tata (Time of year)
Daughter: Pezi zifo (Female offspring)
Day: Tadi (~)
Dead: Pipi (~)
Deaf: Suke beve (Cannot hear)
Deal: Do kafi (Agreement)
Dear: Feta (Loved)
Debate: Kafa (~)
Debt: Va vatu vave (Money that should be payed)
Decent: Gaga (~)
Decide: Gage (~)
Declare: Kavi (~)
Decline: Tu kafi(Not agree)
Deep: Gefo (~)
Defeat: Gati (~)
Defend: Vupu (~)
Define: Kadu vo kako (State the meaning of)
Definite: Saki (~)
Degree: Dede (~)
Delay: Do deta tata (Waiting time)
Deliberately: Keko gagu (By intention)
Deliver: Tepa (~)
Demand: Vapa (~)
Democracy: Seda peka do vako vase (Government in which everyone has some control)
Demonstrate: Beko (~)
Dentist: Fa keba davo (Mouth fixing person)
Deny: Kufi (~)
Department: Vase dagi (Part of an authority)
Departure: Tidi (~)
Depend: Zeda (~)
Dependent: Gaba (~)
Deposit: Teko vape (Put money into)
Depression: Do figi do pigi (Sadness disease)
Depth: Do gefo (~)
Derive: Kapo keko do kegi (Find using logic)
Describe: Kave (~)
Desert: Sizu vefa dadu (Land with scarce rain)
Deserve: Vatu zepa (Should have)
Design: Gagu (~)
Desire: Gapa (~)
Desk: Do vadi zavu (Work table)
Desperate: Zepa sezu vo gage (Having few options)
Despite: Zesa (~)
Destroy: Ku (~)
Detail: Gagu dagi (Part of design)
Detect: Beki (~)
Determination: Gapa do safo (Wanting to achieve)
Determine: Kapo (~)
Develop: Sata fa deko sato (Become more complete)
Device: Zato (~)
Devil: Vaza gugi peka (Bad religion man)
Diagram: Gagu zaka (Design picture)
Diamond: Deda bazu veke (Hardest gem)
Diary: Zabi vo kake du zapa (Book for writing thoughts)
Die: Sata fo pipi (Become dead)
Diet: Vo fato (Things which someone eats)
Differ: Sugi deku (Be different with respect to)
Different: Sugi (~)
Difficult: Kibi (~)
Dig: Ka gete pi dadu (Make a hole in the ground)
Dimension: Geke pi pado (Length in a direction)
Dinner: Tubi fadi (Night food)
Direct: Vapi (~)
Direction: Pado (~)
Directory: Peka kaka zefi (List of information about people)
Dirt: Vedu (~)
Dirty: Kidu (~)
Disabled: Tu sake (Not able to do something)
Disagree: Kufi (~)
Disappear: Tezu do befe (Leave sight)
Disappoint: Deko gugi deku vo kaba (Be worse than expected)
Disaster: Zu gugi satu (Very bad event)
Disc: Gebe geso sabo (Flat circle object)
Discipline: Kate gagi do deke (Teach good behavior)
Discount: Deko za vapo (Lower price)
Discover: Kapo (~)
Discuss: Kadu (~)
Disease: Do pigi (~)
Disgust: Kepu (~)
Dish: Favu (~)
Dismiss: Vapa da tidi (Command to leave)
Display: Bapa gi zaka zato (Electronic picture device)
Dispute: Kafa (~)
Distance: Geke (~)
Distant: Puki (~)
Distinct: Zepa sugi sage (Having a different identity)
Distinguish: Kapo fo sugi (Determine the difference between)
Distribute: Zeve di sezu peka (Give to many people)
District: Dadu gagi (Part of land)
Disturb: Fepu (~)
Divide: Gedi (~)
Divorce: Zita (~)
Do: Deka (~)
Document: Zavo do kave (Text report)
Dog: Peko (~)
Dollar: Seka (~)
Domestic: Pagi (Pertaining to home)
Dominate: Gati (~)
Door: Dade (~)
Dot: Geso zavi (Circle mark)
Double: Sepi seta (Amount multiplied by two)
Doubt: Kupe (~)
Down: Pufa (~)
Draft: Tu sato gagu (Form before completion)
Drag: Baza (~)
Drama: Gaku (~)
Draw: Zabi (~)
Drawer: Do pasu teze gegu (Sliding storage box)
Dream: Va pevu kake (Sleep thinking)
Dress: Ka da zazo (Cause to wear)
Drink: Fapi (~)
Drive: Vako (~)
Drop: Tebo (~)
Drug: Vegi (~)
Drunk: Fapo dedu (Affected by alcohol)
Dry: Kipi (~)
Duck: Vedo pebe (Water bird)
Dude: Pezu peka (Male person)
Due: Vatu sato tuso tata (Should be completed before a time)
Dull: Fifo (~)
Dumb: Kika (~)
Dump: Tebo (~)
During: Tapi (~)
Dust: Vebe (~)
Duty: Vado (~)
Each: Seda (~)
Ear: Do beve daga (Hearing organ)
Early: Tatu (~)
Earn: Zevo keko do vadi (Receive by means of work)
Earth: Padu (~)
East: Pade (~)
Easy: Kebi (~)
Eat: Fato (~)
Economy: Vape zese (Money system)
Edge: Geke (~)
Edition: Zavo keta (Version of text)
Educate: Kate (~)
Effect: Vo ka (Something which is caused)
Effective: Gaka so deku da ka (Good for causing something)
Efficient: (Using a small amount of something valuable)
Effort: Do vadi (~)
Egg: Peti (~)
Either: Go (~)
Elderly: Tuza (~)
Elect: Gage (~)
Electricity: Bapa (~)
Element: Dagi (~)
Elevator: Fa tefa zase (Lift machine)
Else: Zeko tu (If not)
Email: Bapa zave (Electronic mail)
Embarrassed: Fetu (~)
Emerge: (Come into sight)
Emergency: Gaku (~)
Emotion: Feku (~)
Emphasize: Beko do gake (Show the importance of)
Empire: Zu vase (Big government)
Employ: Gato (~)
Empty: Zada (~)
Enable: Ka da sake (Cause to be possible)
Encounter: Zefe (~)
Encourage: Ka da gapa da deka (Cause to want to do something)
End: Suti (~)
Enemy: Zipi (~)
Energy: Badi (~)
Engage: Vada (~)
Engine: Do tefo zase (Spin machine)
Engineer: Fa ka zase (Machine making person)
Enhance: Ka da deko gagi (Make better)
Enjoy: Feta (~)
Enormous: Zu zu (Very big)
Enough: Dego (~)
Enquiry: Kazi (~)
Ensure: Ka da kaki (Cause to be certain)
Enter: Tezu (~)
Enterprise: Vazo (~)
Entertain: Fedo (~)
Enthusiastic: Beko do feta (Showing enjoyment)
Entire: Deto (~)
Entitle: Zeve saka (Give a name)
Envelope: Vepa gi zave zapi (Paper mail container)
Environment: Pase (~)
Equal: Sagi (~)
Equipment: Zato (~)
Equivalent: Sagi so deku saki gasa (Same with respect to a particular purpose)
Era: Gefi tata (Long time)
Error: Gapo (~)
Escape: Tizu (~)
Especially: Sigu zu (Uncommonly very)
Essay: Gefi zavo zedu (Long text pertaining to something)
Essential: Va gaba gako gasa (Required for a purpose)
Establish: Ka (~)
Estate: Pagi dadu (Home land)
Estimate: Kaba (~)
Ethnic: Keva (~)
Even: Dedo (~)
Evening: Tabi ziti (End of day)
Event: Satu (~)
Eventual: Saba so taso gefi tata (Happening after a long time)
Ever: Sagu tata (Any time)
Every: Seda (~)
Evidence: Fa beko fo ta (Something which indicates a truth)
Evil: Zu kive (Very mean)
Exact: Saki (~)
Exam: Vo kapa do kade (Knowledge test)
Examine: Befo (~)
Example: Sade (~)
Excellent: Zu gagi (Very good)
Except: Zetu (~)
Exchange: Zeve ga zevo (Give and receive)
Excite: Fefi (~)
Exclude: Tu pi (Not be in)
Excuse: Beko da vato (Show to be fair)
Executive: Do vako (Pertaining to control)
Exercise: Vade (~)
Exhibition: Da febo beko (Art show)
Exist: Sasa (~)
Exit: Tizu (~)
Expand: Sata fa deko zu (Become larger)
Expect: Kaba (~)
Expensive: Zepa zu vapo (Having a large price)
Experience: Do vadi vo kapa (Work knowledge)
Experiment: Kade (~)
Expert: Kapa fo sezu (Knowing a lot about something)
Explain: Kave (~)
Explode: Bafo (~)
Explore: Te gako do kati (Travel for learning)
Export: Teve di sugi papo (Send to another place)
Expose: Beko (~)
Express: Kadu (~)
Extend: Sata fa deko gefi (Become longer)
Extensive: Deto (~)
Extent: Dede (~)
External: Pe (~)
Extra: Dega (~)
Extraordinary: Zu gagi (Very good)
Extreme: Dezu (~)
Eye: Dafe (~)
Face: Daze (~)
Facility: Gaka papo (Useful place)
Fact: Ta kaka (True concept)
Factor: Dagi (~)
Factory: Ka sabo du zazu (Item creation building)
Fail: Guti (~)
Fair: Vato (~)
Faith: Kape (~)
Fall: Tebo (~)
False: Tu (~)
Familiar: Kapa (~)
Family: Zeva (~)
Famous: Kevi (~)
Fan: Vezo zato (Air tool)
Fancy: Kebu (~)
Fantastic: Zu gagi (Very good)
Far: Puki (~)
Farm: Fadi dadu (Food land)
Fascinate: Fefo (~)
Fashion: Kefe (~)
Fast: Teta (~)
Fat: Vefo (~)
Father: Pezu zefo (Male parent)
Fault: Gugi dagi (Bad part)
Favor: Sigu do gave (Special help)
Favorite: Deda feta (Most enjoyed)
Fear: Feka (~)
Feature: Gagi dagi (Good part)
Federal: Vase (~)
Fee: Vapo (~)
Feed: Zeve fadi (Give food)
Feedback: Zeve vo kape (Shared opinion)
Feel: Beki (~)
Female: Pezi (~)
Fence: Veka davi (Wooden wall)
Festival: Fegu (~)
Fetch: Tepa (~)
Few: Sizu (~)
Field: Pede dadu (Grass land)
Fight: Vapu (~)
Figure: Gega (~)
File: Kaka zapi (Data container)
Fill: Ka da zada (Cause to be full)
Film: Zaku (~)
Filthy: Kidu (~)
Final: Zito (~)
Financial: Vape (Pertaining to money)
Find: Kapo (~)
Fine: Gaga (~)
Finger: Dage (~)
Finish: Safo (~)
Fire: Veda (~)
Firm: Viga (~)
First: Zeto (~)
Fish: Pedo (~)
Fit: Bazu (~)
Fix: Keba (~)
Flash: Beti (~)
Flat: Gebe (~)
Flavor: Bepu (~)
Flesh: Fape (~)
Flood: Vedo gaku (Water emergency)
Floor: Davu (~)
Flow: Vepi do te (Liquid movement)
Flower: Kefo pepa daga (Beautiful plant organ)
Fly: Tepe (~)
Focus: Kata (~)
Fold: Bado (~)
Follow: Zeso (~)
Food: Fadi (~)
Foot: Date (~)
Football: Date gi gego feba (Foot ball sport)
For: Gako (~)
Force: Babu (~)
Foreign: De sugi dadu (From a different land)
Forest: Pevi dadu (Tree land)
Forever: Tapi seda tata (During all times)
Forget: Kuti (~)
Forgive: Sufi do feda (Stop being angry toward)
Fork: Sezu dafi zato (Many prong utensil)
Form: Gega (~)
Formal: Kebu (~)
Formation: Papo zeze (Position organization)
Former: Ziso (~)
Formula: Seku do zede (Number relationship)
Fortunate: Gagi saku (Having good luck)
Fortune: Sezu vape (A lot of money)
Forward: Pafo (~)
Foundation: Gifa (Bottom)
Frame: Gezi (~)
Frank: Kadu fo ta (Saying the truth)
Free: Vage (~)
Freeway: Sezu zaso zaze (Many vehicle road)
Freeze: Sata vepo (Become a solid)
Frequent: Sezu (~)
Fresh: Taza (~)
Friend: Zepi (~)
Frighten: Feka (~)
From: De (~)
Front: Pago (~)
Fruit: Fasi (~)
Fry: Fada so pi vedi (Cook in oil)
Fuel: Fadi (~)
Fulfil: Safo vo gaba (Achieve requirements)
Full: Deto (~)
Fully: Deto (~)
Fun: Fedo (~)
Function: Vadi (~)
Fund: Vape gako saki gasa (Money for a specific purpose)
Fundamental: Gake so deku sezu su (Important for many things)
Funeral: Do pipi fegu (Death ceremony)
Funny: Fedo (~)
Furniture: Zaga (~)
Future: Ba (~)
Gain: Zevo (~)
Gallery: Febo vazu (Art shop)
Game: Feba (~)
Gang: Peka zegu (Group of people)
Gap: Gepe (~)
Garage: Zaso zazu (Vehicle building)
Garbage: Gapu (~)
Garden: Pepa za dadu (Small plant land)
Garlic: Bazu bepe fapa (Strong smell vegetable)
Gas: Vepe (~)
Gasoline: Vedi gi zaso fadi (Vehicle oil fuel)
Gate: Dade (~)
Gather: Pake tedi (Come together)
Gay: Feta sagi peze (Preferring the same gender)
Gear: Zeve babu du dado (Force transfer wheel)
Gene: Dasa kaka (Cell data)
General: Suki (~)
Generate: Ka (~)
Generous: Sezu zeve (Giving often)
Gentle: Kepa (~)
Genuine: Ta (~)
Get: Zevo (~)
Giant: Zu zu (Very big)
Gift: Vo zeve (~)
Girl: Pezi peta (Female child)
Give: Zeve (~)
Glad: Fegi (~)
Glance: Teta befo (Look quickly)
Glass: Vebi (~)
Global: Deto padu (Pertaining to the entire Earth)
Glove: Dabu zaza (Hand clothing)
Go: Te (~)
Goal: Gago (~)
God: Vaza peka (Religion person)
Gold: Gake ga bete veto (Valuable yellow metal)
Golf: Puki gete feba (Distant hole sport)
Good: Gagi (~)
Goodbye: Kufe (~)
Gorgeous: Kefo (~)
Government: Vase (~)
Grab: Bapo (~)
Grade: Keke dafa (Quality level)
Gradual: Tita (~)
Gram: Seka (~)
Grammar: Kase zeze (Language organization)
Grand: Zu (~)
Grandfather: Zefo pezu zefo (Male parent of parent)
Grandmother: Zefo pezi zefo (Female parent of parent)
Grant: Zeve (~)
Graph: Zaka beko sezu seku (Picture representing many numbers)
Grass: Pede (~)
Grateful: Beki kafo (Feeling gratitude toward)
Gray: Bego (~)
Great: Zu (~)
Green: Bede (~)
Grocery: Vuvo fadi (Sold food)
Gross: Kepu (~)
Ground: Dadu (~)
Group: Zegu (~)
Grow: Sata fa deko zu (Become larger)
Guarantee: Kadu da kaki (Say that something is certain)
Guard: Vupu (~)
Guess: Kaba (~)
Guest: Fa tate ti (Someone who stays temporarily)
Guide: Vapi (~)
Guilty: Fetu (~)
Guitar: Fesa gi zafi zato (String music instrument)
Gun: Do bafu zato (Shooting device)
Guy: Pezu peka (Male person)
Habit: Sezu detu (Frequent action)
Hair: Dada (~)
Half: Sipi seta (~)
Hall: Gefi dazu (Long room)
Hand: Dabu (~)
Handle: Dapo (~)
Handy: Gaka (~)
Hang: Bavi (~)
Happen: Saba (~)
Happy: Fegi (~)
Hard: Viga (~)
Hardly: Degi tu (Almost not)
Harm: Kiba (~)
Hat: Daku gefa zaza (Head top clothing)
Hate: Fita (~)
Have: Zepa (~)
Head: Daku (~)
Healthy: Pegi (~)
Hear: Beve (~)
Heart: Vesa daga (Blood organ)
Heat: Do keda (~)
Heaven: Vaza gagi papo (Good religion place)
Heavy: Zu babo (Having a large weight)
Height: Pavi geke (Vertical length)
Hell: Vaza gugi papo (Bad religion place)
Hello: Kafe (~)
Help: Gave (~)
Hence: Zisa (~)
Her: Po (~)
Here: Vi (~)
Hero: Fa kede vupu (Brave protecting person)
Hesitate: Fepi deta (Nervous wait)
Hi: Kafe (~)
Hide: Biko (~)
High: Pafa (~)
Highlight: Beko do gake (Show the importance of)
Highway: Sezu zaso zaze (Many vehicle road)
Hill: Dafu (~)
Him: To (~)
Hire: Zeve vado (Give a job)
History: Tata do kati (Time study)
Hit: Baka (~)
Hold: Bado (~)
Hole: Gete (~)
Holiday: Tu do vadi tadi (No work day)
Holy: Vaza (Pertaining to religion)
Home: Pagi (~)
Honest: Kadu fo ta (Saying the truth)
Honey: Pesa bezi vepi (Sweet arthropod liquid)
Honor: Zu fepa (Respected a lot)
Hook: Do bapo zato (Holding tool)
Hope: Gapa (~)
Horrible: Zu gugi (Very bad)
Horror: Do feka (Scary feeling)
Horse: Zaso pepe (Vehicle animal)
Hospital: Do pegi zazu (Health building)
Host: Fa zeka satu (Event organizer)
Hot: Keda (~)
Hotel: Sezu ga tate pagi zazu (Many temporary home building)
Hour: Tako (~)
House: Pagi zazu (Home building)
How: Sazi ketu (Which manner)
However: Zesa (~)
Huge: Zu zu (~)
Human: Peka (~)
Hungry: Gapa fadi (Wanting food)
Hunt: Gatu da vapu (Try to kill)
Hurry: Teta vadi (Work quickly)
Hurt: Kiba (~)
Husband: Pezu zete (Male spouse)
I: Ki (~)
Ice: Vepo vedo (Solid water)
Ice cream: Kida fage fagi (Cold milk dessert)
Idea: Kaka (~)
Ideal: Deda gagi (Most good)
Identity: Sage (~)
Idiot: Fo kika (Dumb person)
If: Zeko (~)
Ignore: Kuta (~)
Ill: Pigi (~)
Illegal: Guko vaka (Against the law)
Illustrate: Zabi zaka (Draw a picture)
Image: Zaka (~)
Imagine: Kake (~)
Immediate: Zu taki (Very soon)
Impact: Do baka (~)
Implement: Ka keko gagu (Create according to a plan)
Implication: Vo kako (~)
Imply: Kako (~)
Import: Tepa de sugi papo (Bring from another place)
Important: Gake (~)
Impose: Ka keko do bazu (Cause by means of strength)
Impossible: Suke (~)
Impress: Ka da feta (Cause to appreciate)
Improve: Ka da deko gagi (Cause to become better)
In: Pi (~)
Incident: Satu (~)
Include: Pi (Be in)
Income: Vave vape (Payed money)
Increase: Ka da deko sezu (Cause to become more numerous)
Incredible: Suke kape (Not possible to believe)
Indeed: Kaki (~)
Independent: Tu zeda sugi (Not depending on others)
Index: Zefi papo (Sequence position)
Indicate: Beko (~)
Individual: Seto (~)
Industry: Vazo zese (System of companies)
Inevitable: Kaki ga ba saba (Definitely going to happen)
Infant: Pete (~)
Infection: Pigi fo pepi deku zapi (Living things unhealthy for container)
Inflation: Sati zu so keko vezo (Become larger by means of air)
Influence: Dedu (~)
Inform: Kadu (~)
Informal: Kibu (~)
Initial: Zeto (~)
Initiative: Da sake safi (Ability to start something)
Injure: Kiba (~)
Inner: Pi (~)
Innocent: Tu fetu (Not guilty)
Innovation: Ka taza kaka (Creating new ideas)
Input: Zevo kaka (Received information)
Inquiry: Vo kazi (~)
Insect: Seso date pesa (Six foot arthropod)
Inside: Pi (~)
Insist: Vapa keko babu (Demand with force)
Inspect: Befo (~)
Install: Teko gako do gato (Place for usage)
Instance: Sade (~)
Instant: Zu gifi tata (Very short time)
Instead: Zepo (~)
Institution: Peka zese gako saki gasa (System of people for a particular purpose)
Instruct: Kate (~)
Instrument: Zato (~)
Insurance: Gapo vape (Accident money)
Intelligent: Keka (~)
Intend: Zepa gagu (Have an intention)
Intense: Dezu (~)
Interaction: Pake dedu (Acting upon together)
Interest: Fefo (~)
Internal: Pi (~)
International: Sezu vadu (Pertaining to many countries)
Internet: Zadu (~)
Interpret: Gatu da kadi (Try to understand)
Interval: Geke (~)
Intervention: Depi gugi do deke (Interrupt bad behavior)
Interview: Do kazi tata (Question time)
Into: Pi di (In to)
Introduce: Gave da zefe (Help meet)
Invest: Vave gako do zevo (Spend for the purpose of gaining)
Investigate: Kati (~)
Invite: Vagi da tezu (Allow to enter)
Involve: Sa dagi (Be a part of)
Iron: Baba bego veto (Gray magnetic metal)
Island: Dapi gezi dadu (Ocean border land)
Issue: Gaku (~)
It: Bo (~)
Item: Sabo (~)
Jacket: Pafa dazo keda zaza (Warm upper torso clothing)
Jam: Fasi vezu vepi (Thick fruit fluid)
Job: Vado (~)
Join: Gepa (~)
Joint: Dadi (~)
Joke: Do kadu fedo (Funny communication)
Journalist: Fa zabi zata (News writer)
Journey: Do te (~)
Joy: Do feta (~)
Judge: Kaba (~)
Juice: Fasi vepi (Fruit liquid)
Jump: Bade ge di vezo (Push self into the air)
Junior: Taza peka (Young person)
Jury: Peka zegu gage do fetu (Group of people deciding guilt)
Just: Sedo (~)
Justice: Do vato (~)
Justify: Beko da kegi (Show to be reasonable)
Keen: Feta (~)
Keep: Pasu (~)
Kettle: Keda fapi zapi (Hot beverage container)
Key: Dabe (~)
Keyboard: Zava dabe zato (Symbol key device)
Kick: Baka keko date (Hit by means of foot)
Kid: Peta (~)
Kill: Ka da pipi (Cause to die)
Kind: Keve (~)
King: Fa vako vadu (Country ruler)
Kiss: Babi keko davo (Touch by means of mouth)
Kit: Sabo zegu gako saki gasa (Group of items for a specific purpose)
Kitchen: Do fada dazu (Cooking room)
Knee: Dagu dadi (Leg joint)
Knife: Do bati zato (Cutting tool)
Knock: Baka (~)
Know: Kapa (~)
Lab: Kagi dazu (Science room)
Label: Fa zavo vepa bapu (Bonded text paper)
Labor: Vadi (~)
Lack: Tu zepa (Not have)
Ladder: Pafa te du zato (Move up tool)
Lady: Pezi peka (Female person)
Lake: Dapi (~)
Lamb: Taza pege (Young sheep)
Lamp: Bebi zato (Light tool)
Land: Dadu (~)
Lane: Zaze patu dagi (Parallel part of road)
Language: Kase (~)
Large: Zu (~)
Last: Zito (~)
Late: Tutu (~)
Latter: Taso (~)
Laugh: Fefa (~)
Launch: Sati (~)
Law: Vaka (~)
Lawyer: Fa kapa vaka (Law knowing person)
Lay: Gevu (~)
Layer: Dafa (~)
Lazy: Za vadi (Not working a lot)
Lead: Vapi (~)
Leaf: Dasu (~)
League: Feba do vapu (Sports competition)
Lean: Bade keko babo (Pushing by means of gravity)
Learn: Kati (~)
Least: Dida (~)
Leather: Pegu geze (Cow skin)
Leave: Tidi (~)
Lecture: Do kate (~)
Left: Pugu (~)
Leg: Date dagu (Foot limb)
Legal: Vaka (Pertaining to law)
Leisure: Do vavu (~)
Lend: Tate zeve (Temporarily give)
Length: Geke (~)
Less: Diko (~)
Lesson: Do kate (~)
Let: Vagi (~)
Letter: Zava (~)
Level: Dafa (~)
Liberal: Sizu sezi (With few constraints)
Library: Zapa zazu (Book building)
License: Vase do vagi (Authority permission)
Lick: Babi keko bepu daga (Touch with taste organ)
Lid: Fo zapu (~)
Lie: Gevu (~)
Lift: Tefa (~)
Light: Bebi (~)
Lighting: Bebi (~)
Like: Kezu (~)
Likely: Sazu (~)
Limit: Sezi (~)
Line: Geke (~)
Link: Gepa (~)
Lip: Davo gezi (Mouth border)
Liquid: Vepi (~)
List: Zefi (~)
Listen: Bevo (~)
Literal: Keko ta vo kako (According to actual meaning)
Literature: Kabo febo (Word art)
Little: Za (~)
Live: Pepi (~)
Load: Vo tepa (~)
Loan: Tate vave (Pay temporarily)
Local: Papo paki (Pertaining to nearby places)
Location: Papo (~)
Lock: Zatu (~)
Log: Pevi dazo dagi (Tree torso piece)
Logical: Kegi (~)
Lonely: Sedo figi (Sad about being alone)
Long: Gefi (~)
Look: Befo (~)
Loose: Tu badu (Not compressing)
Lord: Vaza peka (Religion person)
Lose: Guti (~)
Lost: Tu kapa papo (Not knowing location)
Lot: Sezu (~)
Loud: Beva (~)
Lounge: Do vavu dazu (Relaxation room)
Love: Feta (~)
Low: Pufa (~)
Lucky: Gagi saku (Good chance)
Lump: Gefu (~)
Lunch: Tabi pazo fadi (Middle of day food)
Machine: Zase (~)
Mad: Feda (~)
Magazine: Tadu sezu tata zapa (Book created several times per year)
Magic: Tu keko kagi (Not by means of science)
Mail: Zave (~)
Main: Zezu (~)
Maintain: Pegi pasu (Keep healthy)
Major: Gake (~)
Make: Ka (~)
Male: Pezu (~)
Mall: Sezu vazu zazu (Building of many shops)
Man: Pezu peka (Male person)
Manage: Vako (~)
Manner: Ketu (~)
Manufacture: Ka sabo(Create an item)
Many: Sezu (~)
Map: Zaka kako dadu (Image representing land)
March: Pake teso so gako sako gasa (Walk together for a particular purpose)
Margin: Gezo gepe (Space on the side)
Mark: Zavi (~)
Market: Do vavo papo (Place for buying things)
Marry: Zeta (~)
Marvellous: Zu gagi (Very good)
Mass: Sabu (~)
Master: Fo vako (~)
Match: Kapu su kezu (Find similar things)
Material: Vepu(~)
Math: Seku kagi (Number science)
Matter: Sabu (~)
Maximum: Deda sezi (Biggest limit)
May: Sadi (~)
Maybe: Sadi (~)
Meal: Do fato fadi (Food for eating)
Mean: Kako (~)
Measure: Kapo seku (Find amount)
Meat: Fape (~)
Mechanism: Ketu (~)
Media: Sezu peka do kadu (Communication to many people)
Medicine: Vegi (~)
Medieval: Zu tuza (Very old)
Medium: Pazo seku (Middle amount)
Meet: Zefe (~)
Member: Zega (~)
Memory: Vo kapi (~)
Mental: Do kake (Pertaining to thought)
Mention: Gifi kadu (Briefly talk about)
Menu: Vo gage zefi (List of options)
Message: Vo kadu (~)
Messy: Kidu (~)
Metal: Veto (~)
Meter: Seka (~)
Method: Ketu (~)
Middle: Pazo (~)
Midnight: Tubi pazo (Middle of the night)
Might: Sadi (~)
Military: Da vadu vapu (Pertaining to combat of nations)
Milk: Fage (~)
Mind: Do kake zese (Thought system)
Mine: Ki (~)
Mineral: Pepu vepo tu zepa zeku seso daza (Natural solid not containing carbon)
Minimum: Dida sezi (Smallest limit)
Minor: Guke (~)
Minority: Sigo (~)
Minute: Take (~)
Mirror: Zaka tebu du geze (Image reflecting surface)
Misery: Do figi (~)
Miss: Tu baka (Not hit)
Mission: Gago (~)
Mistake: Gapo (~)
Mix: Zika (~)
Mixture: Vo zika (~)
Mobile: Sake tepo (Able to move)
Mode: Keta (~)
Model: Sade (~)
Modern: Taza kefe (New style)
Mom: Pezi zefo (Female parent)
Moment: Gifi tata (Short time)
Money: Vape (~)
Monitor: Zaka zase (Image machine)
Month: Tada (~)
Mood: Feku (~)
Moon: Pape (~)
Moral: Do vato vaka (Rule pertaining to fairness)
More: Deko (~)
Morning: Tabi zeti (Start of day)
Mortgage: Zazu vapo (Building cost)
Most: Deda (~)
Motion: Do te (~)
Motor: Da zase tefo (Turning machine)
Mountain: Dafu (~)
Mouse: Zu za peda (Very small mammal)
Mouth: Davo (~)
Move: Te (~)
Movie: Zaku (~)
Much: Sezu (~)
Mud: Kepi vedu (Wet dirt)
Murder: Ka da pipi (Causing death)
Muscle: Fape (~)
Museum: Zazu beko tuza sabo (Building showing old objects)
Mushroom: Pepo (~)
Music: Fesa (~)
Must: Gaba (~)
My: Ki (~)
Mystery: Setu peka kapa (Something nobody knows)
Nail: Dage geze veko (Finger surface bone)
Naked: Zazo setu zaza  (Not wearing anything)
Name: Saka (~)
Narrow: Gife (~)
Nasty: Kepu (~)
Nation: Vadu (~)
Native: Peva so pi (Born in a particular place)
Nature: Pepu (~)
Naughty: Kive (~)
Near: Paki (~)
Nearly: Degi (~)
Neat: Zeka (~)
Necessary: Gaba (~)
Neck: Daku dagu (Head limb)
Need: Gaba (~)
Negative: Sedu (~)
Negotiate: Ka keko do kadu (Cause by means of discussion)
Neighbor: Peka paki (Nearby person)
Neither: Tu su ga tu fa sugi su (Not something and not something else)
Nerve: Dasa teve kaka (Cell for transmitting information)
Nervous: Fepi (~)
Net: Gese (~)
Network: Gese (~)
Never: Setu tata (At no time)
New: Taza (~)
News: Zata (~)
Next: Zeso (~)
Nice: Keve (~)
Night: Tubi (~)
No: Tu (~)
Nod: Daku pavi tezo (Vertically shake head)
Noise: Bezo (~)
None: Setu (~)
Nonsense: Fo kigi (~)
Nope: Tu (~)
Nor: Tu su ga tu fa sugi su (Not something and not something else)
Normal: Segu (~)
North: Padi (~)
Nose: Bepe daga (Smell organ)
Not: Tu (~)
Notable: Gake so deku do kata (Important to notice)
Note: Do kapi zavo (Text for remembering)
Nothing: Setu su (No thing)
Notice: Kata (~)
Notion: Kaka (~)
Novel: Katu zapa (Story book)
Now: Zi (~)
Nowhere: Setu papo (In no place)
Nuclear: Daba ga dabo (Pertaining to protons and neutrons)
Nuisance: Fo fepu (~)
Number: Seku (~)
Nurse: Keba pebo du peka (Healing body person)
Nut: Pedi (~)
Object: Sabo (~)
Objective: Gago (~)
Obligation: Va vatu deka (Something which should be done)
Observe: Befo (~)
Obtain: Zevo (~)
Obvious: Zefe (~)
Occasion: Satu tata (Time of event)
Occasional: Tu sezu (Not often)
Occupation: Vado (~)
Occupy: Pi (Be inside)
Occur: Saba (~)
Ocean: Dapi (~)
Odd: Segu (~)
Odds: Saku (~)
Of: Zede (~)
Off: Pubi (~)
Offense: Do vapu (Pertaining to attack)
Offer: Vagi da zepa (Allow to have)
Office: Do vadi zazu (Work building)
Official: Vase kafi (Approved by an authority)
Often: Sezu (~)
Oil: Vedi (~)
Okay: Gaga (~)
Old: Tuza (~)
On: Pabi (~)
Once: Seto tata (One time)
One: Seto (~)
Onion: Dafe vedo fapa (Eye water vegetable)
Only: Sedo (~)
Onto: Pabi di (On to)
Open: Zate (~)
Operate: Vadi (~)
Opinion: Vo kape (~)
Opponent: Vo vapu (~)
Opportunity: Fo sake pase (Circumstance for possibility)
Oppose: Guko (~)
Opposite: Desa (~)
Option: Vo gage (~)
Or: Go (~)
Orange: Beta (~)
Order: Zeze (~)
Ordinary: Segu (~)
Organ: Daga (~)
Organize: Zeka (~)
Origin: Zeti papo (Starting place)
Original: Zeto (First)
Other: Sugi (~)
Ought: Vatu (~)
Our: Bi (~)
Out: Pe (~)
Outcome: Vo ka (~)
Output: Zeve kaka (Given information)
Outside: Pe (~)
Outstanding: Zu gagi (Very good)
Oven: Do fada zase (Cooking machine)
Over: Paga (~)
Owe: Vatu zeve (Should give)
Own: Zepa (~)
Pace: Teku (~)
Pack: Teko pi zapi (Put into container)
Package: Zapi (~)
Packet: Zasu zapi (Bag container)
Pad: Vega gebe sabo (Soft flat object)
Page: Vepa dagi (Paper piece)
Pain: Feti (~)
Paint: Bebe gi do zabi vepi (Color drawing liquid)
Painting: Dabu ka zaka (Picture created by hand)
Pair: Seta su (Two things)
Palace: Vase peka pagi (Home of government person)
Pale: Bisu (~)
Pan: Do fada gebe zabo (Flat cooking bowl)
Panel: Geze dagi (Surface piece)
Panic: Fepi (~)
Pants: Date dagu zaza (Foot limb clothing)
Paper: Vepa (~)
Pardon: Suti feda so zedu (Stop being angry toward)
Parent: Zefo (~)
Park: Pepu dadu  (Nature land)
Part: Dagi (~)
Participate: Deka (~)
Particular: Saki (~)
Partner: Fa pake vadi (Person working together)
Party: Fegu (~)
Pass: Te paki (Go by)
Passage: Do te (~)
Passenger: Fa pi zaso (Person going in a vehicle)
Passion: Do bazu feta (Strong enjoyment)
Past: Fo bu (~)
Path: Tega (~)
Patient: Sake deta (Able to wait)
Pattern: Kezo (~)
Pause: Tate suti (Temporarily stop)
Pay: Vave (~)
Peace: Setu do vapu (No fighting)
Peak: Gefa (~)
Pen: Vepi do zabi zato (Liquid writing tool)
Penalty: Guvo (~)
Pencil: Bego vepo do zabi zato (Gray solid writing tool)
Penny: Seki setu seto seka sabo (0.01 dollar object)
Pepper: Begi fapa (Spicy vegetable)
Per: Gako seda (For each)
Perceive: Beki (~)
Perfect: Deda gagi (Most good)
Perform: Deka (~)
Perhaps: Sadi (~)
Period: Tata geke (Time interval)
Permanent: Tute (~)
Permit: Vagi (~)
Person: Peka (~)
Personality: Do deke keke (Quality of behavior)
Perspective: Do beki papo (Position of perception)
Persuade: Gatu da ka da (Try to cause to do something)
Phase: Keta (~)
Philosophy: Do sasa kagi (Science of existence)
Phone: Zasa (~)
Photo: Zaka (~)
Phrase: Kabo zegu (Group of words)
Physical: Sabo (Pertaining to physical entities)
Piano: Dabe gi zafi fesa zato (Button string music instrument)
Pick: Gage (~)
Picture: Zaka (~)
Pie: Fade zabo fagi (Pastry bowl dessert)
Piece: Dagi (~)
Pig: Pego (~)
Pile: Gefu (~)
Pill: Vepo vegi sabo (Solid medicine object)
Pilot: Fa vako tepe zaso (Flying vehicle controller)
Pin: Veto geti dafi (Sharp metal prong)
Pink: Bezu besa (Light red)
Pipe: Gepu (~)
Pitch: Do besi seku (~)
Pity: Sugi feti do figi (Sadness about someone's pain)
Pizza: Fasa gi fagu gebe fade (Flat bread with tomato and cheese)
Place: Papo (~)
Plain: Kebi (~)
Plan: Gagu (~)
Plane: Tepe zaso (Flying vehicle)
Planet: Padu (~)
Plant: Pepa (~)
Plastic: Veti (~)
Plate: Favu (~)
Platform: Do gevi papo (Place for standing)
Play: Febi (~)
Pleasant: Sake feta (Able to be enjoyed)
Please: Ka da fegi (Cause to be happy)
Plenty: Deko so deku fo dego (More than enough)
Plot: Katu (~)
Plug: Bapa vo gepa (Electronic link)
Plus: Sede (~)
Pocket: Zasu (~)
Poem: Febo kabo (Artistic words)
Point: Gasa (~)
Pole: Dafi (~)
Police: Vase do kebe zese (Government security system)
Policy: Vaka (~)
Polite: Keve (~)
Politics: Vase detu (Governemnt activity)
Poll: Da kazi vo gage (Choice inquiry)
Polution: Vepu kiba pepu (Material damaging nature)
Pond: Dapi (~)
Pool: Vedo pebo (Body of water)
Poor: Zepa sizu vape (Not having a lot of money)
Pop: Bafo (~)
Popular: Kevi (~)
Population: Peka seku (Amount of people)
Port: Kaka zako (Data outlet)
Pose: Gatu da zepa gega (Try to have a shape)
Position: Papo (~)
Positive: Sidu (~)
Possess: Zepa (~)
Possible: Sake (~)
Post: Ka da zege (Cause to be public)
Poster: Davi vepa (Wall paper)
Pot: Zabo (~)
Potato: Fadu (~)
Potential: Sake (~)
Pour: Tebo  (~)
Poverty: Tu zepa vape du keta (State of not having money)
Power: Badi (~)
Practical: Do vadi (Pertaining to work)
Practice: Vade (~)
Praise: Kafi (~)
Pray: Vapa da vaza peka gave (Request help from religion person)
Precise: Saki (~)
Predict: Kaba (~)
Prefer: Feta (~)
Pregnant: Pete pi (Contain a baby)
Premise: Ziso vo kape (Previous belief)
Prepare: Sati gaki (Become ready)
Presence: Papo do sasa (Existence in a place)
Present: Gavo (~)
Presentation: Do beko (~)
Preserve: Pasu (~)
President: Vadu fo vapi (Country leader)
Press: Bade (~)
Pressure: Do badu (~)
Presume: Kaba (~)
Pretend: Deke so keko (Act as though)
Pretty: Kefo (~)
Prevent: Ku (~)
Previous: Kiso (~)
Price: Vapo (~)
Pride: Do fitu (~)
Primary: Zezu (~)
Prince: Pezu zifo zede vadu fo vapi (Male child of country ruler)
Princess: Pezi zifo zede vadu fo vapi (Female child of country ruler)
Principal: Zezu (~)
Principle: Zezu vaka (Primary rule)
Print: Zabi keko zase (Draw by means of machine)
Prior: Tuso (~)
Priority: Do gako seku (Amount of importance)
Prison: Guvo zazu (Punishment building)
Private: Zege (~)
Privilege: Sigu fo sake (Special ability)
Prize: Gavo (~)
Probably: Sazu (~)
Problem: Gaku (~)
Procedure: Detu zefi (Sequence of actions)
Proceed: Sati (~)
Process: Detu zese (System of actions)
Produce: Ka (~)
Product: Va vazo ka su (Something created by a company)
Profession: Vado (~)
Professor: Fo kate (~)
Profile: Gezi (~)
Profit: Zevo dega vape (Extra gained money)
Program: Zaki (~)
Progress: Fo sato seku (Amount finished)
Project: Gago (~)
Promise: Kadu da kaki (Say that something will definitely happen)
Promote: Zege kafi (Publicly praise)
Prompt: Vapa kaka (Request information)
Proof: Fa beko fo ta (Something which shows truth)
Proper: Gaga (~)
Property: Vo zepa (~)
Proportion: Seku (~)
Propose: Vapi (~)
Prospect: Saku (~)
Protect: Vupu (~)
Protest: Kafa (~)
Proud: Fitu (~)
Prove: Beko da ta (Show to be true)
Provide: Zeve (~)
Provision: Do zeve (~)
Psychology: Do deke kagi (Behavior science)
Pub: Fapo vazu (Alcohol building)
Public: Zege (~)
Publish: Ka da zege (Cause to be public)
Pudding: Vepi vezu fagi (Viscous liquid desert)
Pull: Bude (~)
Punch: Baka keko dabu (Hit with hand)
Punish: Zeve guvo (Give punishment)
Purchase: Vavo (~)
Pure: Sugi vepu tu pi (Not containing other materials)
Purple: Beso (~)
Purpose: Gasa (~)
Purse: Dabu zasu (Hand bag)
Pursue: Gatu da safo (Try to accomplish)
Push: Bade (~)
Put: Teko (~)
Qualify: Kave keke (Describe quality)
Quantity: Seku (~)
Queen: Fa vako vadu (Country ruler)
Question: Vo kazi (~)
Queue: Zefi (~)
Quick: Teta (~)
Quiet: Biva (~)
Quit: Sufi vado (Stop an occupation)
Quite: Zu (~)
Quote: Saki vo kadu (Exact statement)
Race: Teku feba (Speed game)
Radical: Dezu (~)
Radio: Zape (~)
Rail: Dafi (~)
Rain: Vefa (~)
Raise: Tefa (~)
Range: Geke (~)
Rank: Do zeku (~)
Rapid: Teta (~)
Rare: Sigu (~)
Rate: Teku (~)
Rather: Deko feta (Prefer more)
Ratio: Fa sipi (Amount divided by amount)
Raw: Tu fada (Not cooked)
Reach: Gezu (~)
React: Desi (~)
Read: Zafo (~)
Ready: Gaki (~)
Real: Ta (~)
Realize: Sati kapa (Start to be aware of)
Really: Zu (~)
Reason: Gasa (~)
Reasonable: Kegi (~)
Recall: Kapi (~)
Receipt: Vo vavo zefi (List showing purchases)
Receive: Zevo (~)
Recent: Tafi (~)
Recipe: Do ka vo vapi (Instructions for creating something)
Reckon: Kape (~)
Recognition: Do kapa (~)
Recommend: Vapi (~)
Record: Pasu kaka (Store information)
Recover: Ka da zepa ziso keta (Cause to have previous state)
Red: Besa (~)
Reduce: Ka da diko (Cause to be less)
Refer: Kadu zedu (Talk about)
Reflect: Tebu (~)
Reform: Kefi do deke (Change behavior)
Refridgerator: Do kida zase (Cold machine)
Refuse: Kufi da vagi (Not agree to allow)
Regard: Kake keko (Think about in a specific way)
Regime: Vase (~)
Region: Geka (~)
Register: Pasu kaka (Store information)
Regret: Figi so zedu (Be unhappy about)
Regular: Segu (~)
Regulate: Vako (~)
Reinforce: Ka da bazu (Cause to be stronger)
Reject: Kufi (~)
Relate: Zede (~)
Relax: Vavu (~)
Release: Vuke (~)
Relevant: Bazu zede (Strongly related)
Relief: Do fipi (~)
Religion: Vaza (~)
Rely: Zeda (~)
Remain: Ti (~)
Remark: Kadu zedu (Talk about)
Remarkable: Zu gagi (Very good)
Remember: Kapi (~)
Remind: Ka da kapi (Cause to recall)
Remote: Puki (~)
Remove: Tiko (~)
Rent: Tate vavo (Temporarily buy)
Repair: Keba (~)
Repeat: Sako (~)
Replace: Teko zepo (Put instead of)
Reply: Kasi (~)
Report: Kafe (~)
Represent: Kako (~)
Republic: Va sezu peka gage vase (Government chosen by many people)
Reputation: Va sugi peka kape (Opinions of other people)
Request: Vapa (~)
Require: Gaba (~)
Rescue: Ka da kebe (Cause to be safe)
Research: Kati (~)
Reserve: Pasu gako ba do gato (Keep for future usage)
Resident: Fa peka zepa pagi pi (Person who has a home in a place)
Resign: Sufi vado (Stop an occupation)
Resist: Gatu da sufi (Try to stop)
Resolve: Keba (~)
Resort: Deka so zepo (Do something instead)
Resource: Fo gaka (~)
Respect: Fepa (~)
Respond: Desi (~)
Responsibility: Vado (~)
Responsible: Kepa (~)
Rest: Vavu (~)
Restaurant: Do fato vazu (Eating shop)
Restore: Ka da zepa ziso keta (Cause to have previous state)
Restrict: Ka sezi (Cause a constraint)
Result: Vo ka (~)
Retain: Pasu (~)
Retire: Sufi vado (Stop an occupation)
Return: Pako zeve (Give back)
Reveal: Beko (~)
Revenue: Va zevo vape (Received money)
Reverse: Pufo (~)
Review: Kapu gapo (Look for mistakes)
Revolution: Tedo so keko sete seso setu seka (Rotate by 360 degrees)
Reward: Gavo (~)
Rhythm: Fesa tata kezo (Music time pattern)
Rice: Favi (~)
Rich: Zepa sezu vape (Have a lot of money)
Rid: Ka da vage du de (Cause to be free from)
Ride: Te pi (Travel inside)
Ridiculous: Kedi (~)
Right: Pagu (~)
Ring: Do kavi bezo (Alert sound)
Rip: Gedi (~)
Rise: Pafa te (Go up)
Risk: Fo gugi saku (Chance of something bad)
Rival: Zipi (~)
River: Dapu (~)
Road: Zaze (~)
Rob: Tiko zigi do vagi (Take without permission)
Rock: Veta (~)
Role: Gasa (~)
Roll: Te keko do tedo (Move by rotating)
Roof: Zazu gefa (Building top)
Room: Dazu (~)
Root: Pepa gi vedu daga (Plant soil organ)
Rope: Zafi (~)
Rough: Geza (~)
Roughly: Suki (~)
Round: Gebo (~)
Route: Tega (~)
Routine: Detu segu zefi (Usual sequence of actions)
Row: Pavu zegu (Horizontal group)
Royal: Vase zeva (Pertaining to government family)
Rub: Baza (~)
Rubber: Vebu (~)
Rude: Kive (~)
Ruin: Ka da gugi (Cause to be bad)
Rule: Vaka (~)
Run: Teso (~)
Rural: Puki vagu (Far from the city)
Rush: Teta vadi (Work quickly)
Sack: Zasu (~)
Sad: Figi (~)
Safe: Kebe (~)
Sail: Va vezo bade veza (Air pushing cloth)
Sake: Gasa (~)
Salad: Dasu fadi (Leaf food)
Salary: Vado vape (Occupation money)
Sale: Do vuvo (~)
Salt: Faza (~)
Same: Sagi (~)
Sample: Sade (~)
Sand: Veba (~)
Sandwich: Fade dafa fadi (Bread layer food)
Satellite: Padu gepe zase (Planet space machine)
Satisfy: Safo vo gaba (Complete the needs of)
Sauce: Dega bepu vepi (Extra flavor liquid)
Sausage: Gefi ga gebo fape (Long round meat)
Save: Pasu (~)
Say: Kasa (~)
Scale: Kapo babo du zase (Finding weight machine)
Scare: Feka (~)
Scene: Satu papo (Event place)
Schedule: Tata gagu (Time plan)
Scheme: Gagu (~)
School: Do kati zazu (Learning building)
Science: Kagi (~)
Scope: Do gake pase (Context of importance)
Score: Do gati seku (Success amount)
Scratch: Baze (~)
Scream: Zu beva kasa (Speak very loudly)
Screen: Zaka zase (Image machine)
Screw: Tedo gepa du sabo (Rotating connection object)
Script: Zavo (~)
Sea: Dapi (~)
Seal: Zute (~)
Search: Kapu (~)
Season: Tado (~)
Seat: Do geva papo (Sitting place)
Second: Zeku seta (~)
Secret: Fo zige (~)
Section: Dagi (~)
Secure: Kebe (~)
See: Befe (~)
Seed: Pedi (~)
Seek: Kapu (~)
Seem: Keze (~)
Seize: Teko keko babu (Take by force)
Select: Gage (~)
Self: Ge (~)
Sell: Vuvo (~)
Send: Teve (~)
Senior: Tuza (~)
Sense: Beki (~)
Sensitive: Sake beki za do keti (Able to sense small changes)
Sentence: Kagu (~)
Separate: Puke (~)
Sequence: Zefi (~)
Series: Zefi (~)
Serious: Gake (~)
Serve: Gave (~)
Service: Do gave (~)
Session: Detu geke (Activity interval)
Set: Zegu (~)
Setting: Pase (~)
Settle: Sati kafi (Start to agree)
Several: Seko (~)
Severe: Dezu (~)
Sew: Gepi (~)
Sex: Pefo (~)
Shadow: Bibi (~)
Shake: Tezo (~)
Shame: Do fetu (~)
Shape: Gega (~)
Share: Pake gato (Use together)
Sharp: Geti (~)
Shave: Bati dada (Cut hair)
Shed: Za zazu (Small building)
Sheep: Pege (~)
Sheet: Gebe dagi (Flat piece)
Shelf: Dafa (~)
Shell: Pega veko (Mollusk bone)
Shelter: Kebe papo (Safe place)
Shift: Kefi papo (Change position)
Shine: Ka bebi (Create light)
Ship: Vedo zaso (Water vehicle)
Shirt: Dazo zaza (Torso clothing)
Shock: Feki (~)
Shoe: Date zaza (Foot clothing)
Shoot: Bafu (~)
Shop: Vazu (~)
Short: Gifi (~)
Should: Vatu (~)
Shoulder: Dabu dagu ga dazo pu dadi (Hand limb torso joint)
Shout: Beva kasa (Speak loudly)
Shove: Bade (~)
Show: Beko (~)
Shower: Tepi (~)
Shrug: Tu kapa du gi pebo do kadu (Body communication of not knowing)
Shut: Zute (~)
Sick: Pigi (~)
Side: Gezo (~)
Sight: Do befe (~)
Sign: Fo kavi (~)
Signal: Kaka (~)
Signature: Va zabi saka (Written name)
Significant: Gake (~)
Silent: Tu ka bezo (Not making noise)
Silly: Kedi (~)
Silver: Fa bego gi gake tebu (Reflective gray valuable metal)
Similar: Kezu (~)
Simple: Kebi (~)
Sin: Gugi detu deku vaza (Bad action with respect to religion)
Since: Taso (~)
Sing: Kasa fesa (Speak music)
Single: Seto (~)
Sink: Zabu (~)
Sister: Pezi zefa (Female sibling)
Sit: Geva (~)
Site: Papo (~)
Situation: Pase (~)
Size: Do zu seku (Amount of largeness)
Skill: Da sake deka (Ability to do something)
Skin: Geze (~)
Skirt: Date pafa dagu zaza (Upper foot limb clothing)
Sky: Dape (~)
Sleep: Pevu (~)
Slice: Bati (~)
Slide: Teze (~)
Slight: Za (~)
Slim: Gife (~)
Slip: Teze (~)
Slope: Geze pato (Diagonal surface)
Slow: Tita (~)
Small: Za (~)
Smart: Keka (~)
Smell: Bepe (~)
Smile: Davo fegi gega (Happy mouth shape)
Smoke: Vege (~)
Smooth: Giza (~)
Snap: Gedi (~)
Snow: Veke vefa (Crystal precipitation)
So: Zisa (~)
Soap: Vego (~)
Social: Peka detu (Pertaining to the activity of people)
Society: Fa peka zegu pake vadi (Group of people working together)
Sock: Date vega zaza (Soft foot clothing)
Soft: Vega (~)
Software: Zaki (~)
Soil: Vedu (~)
Soldier: Fo vapu (~)
Sole: Sedo (~)
Solicitor: Fo vapa (~)
Solid: Vepo (~)
Solve: Keba (~)
Some: Seko (~)
Son: Pezu zifo (Male offspring)
Song: Fesa (~)
Soon: Taki (~)
Sore: Zepa feti (Having pain)
Sorry: Fetu (~)
Sort: Zeka (~)
Soul: Feku gi peka dagi (Emotional part of person)
Sound: Bezo (~)
Soup: Vepi fadi (Liquid food)
Source: Zeto papo (Original location)
South: Pudi (~)
Space: Gepe (~)
Spare: Dega (~)
Speak: Kasa (~)
Special: Sigu (~)
Species: Fo pepi kegu (Type of living thing)
Specific: Saki (~)
Specify: Ka da saki (Cause to be more specific)
Speech: Do kasa (~)
Speed: Teku (~)
Spell: Kadu kabo seko zava (Say the letters of a word)
Spend: Vave (~)
Spill: Tebo (~)
Spin: Tedo (~)
Spirit: Feku gi peka dagi (Emotional part of person)
Spite: Gapa da kiba (Desire to damage someone)
Split: Gedi (~)
Spoil: Sati gugi (Become bad)
Spoon: Vepi fadi zato (Liquid food utensil)
Sport: Feba (~)
Spot: Geso zavi (Circle mark)
Spray: Tepi (~)
Spread: Tede (~)
Spring: Fa tado sati keda (Becoming warm season)
Squad: Gago gi peka zegu (Task people group)
Square: Gesu (~)
Squeeze: Badu (~)
Stable: Tebe (~)
Staff: Fo vadi (~)
Stage: Keta (~)
Stair: Dafo (~)
Stake: Va sake zivo (Something which can be lost)
Stall: Ka da deta (Cause to wait)
Stamp: Zave do vave zavi (Mail payment mark)
Stand: Gevi (~)
Standard: Segu (~)
Star: Pada (~)
Stare: Befo tapi zu tata (Look at for a long time)
Start: Sati (~)
Starve: Tu fato du ka do pipi (Die because of not eating)
State: Keta (~)
Station: Tate do vavu zazu (Temporary rest building)
Statistic: Saku seku (Probability number)
Status: Keta (~)
Stay: Ti (~)
Steady: Tebe (~)
Steak: Pegu fape (Cow meat)
Steal: Tiko zigi do vagi (Take without permission)
Steam: Vege (~)
Steel: Deko bazu ga bego veto (Stronger gray metal)
Steep: Zepa zu pado (Having a large angle)
Step: Dafo (~)
Stick: Dage (~)
Stiff: Viga (~)
Still: Tabe (~)
Stir: Zika vepi (Mix a liquid)
Stock: Sabo gako do vuvo (Items for selling)
Stomach: Do favo daga (Digestion organ)
Stone: Veta (~)
Stop: Suti (~)
Storage: Do pasu papo (Place for storing)
Store: Pasu (~)
Storm: Gugi kepe (Bad weather)
Story: Katu (~)
Straight: Gebi (~)
Strain: Ka da zu vadi (Cause to work a lot)
Strange: Sigu (~)
Strategy: Gagu (~)
Straw: Fapi gepu (Drink tube)
Strawberry: Za besa fasi (Small red fruit)
Stream: Dapu (~)
Street: Zaze (~)
Stress: Do fepi (~)
Stretch: Budu (~)
Strict: Sezu teda vaka (Following the rules a lot)
Strike: Baka (~)
String: Zafi (~)
Strip: Zafe (~)
Stroke: Baza (~)
Strong: Bazu (~)
Structure: Gega (~)
Struggle: Zepa gaku zede da deka (Have trouble doing something)
Student: Fo kati (~)
Studio: Febo do vadi papo (Art work place)
Study: Kati (~)
Stuff: Su (~)
Stupid: Kika (~)
Style: Kefe (~)
Subject: Vo zedu (The concept to which something pertains)
Submit: Teve (~)
Substance: Vepu (~)
Substantial: Gake seku (Significant amount)
Succeed: Gati (~)
Such: Fe kegu (That kind of)
Suck: Bude vezo (Pull air)
Sudden: Taka (~)
Suffer: Defi (~)
Sufficient: Dego (~)
Sugar: Fazi (~)
Suggest: Vapi (~)
Suit: Kebu zaza (Formal clothing)
Suitable: Gaga (~)
Sum: Seku do sede (Addition of numbers)
Summer: Keda tado (Hot season)
Sun: Pada (~)
Super: Zu gagi (Very good)
Supply: Zeve (~)
Support: Bapo (~)
Suppose: Kape (~)
Sure: Kaki (~)
Surface: Geze (~)
Surgery: Keba pebo so keko do bati (Fixing a body by means of cutting)
Surprise: Feki (~)
Surround: Pupi (~)
Survey: Kazi di sezu peka (Asking for information from many people)
Survive: Pepi so tuso (Be alive after)
Suspect: Kaba (~)
Sustain: Ka da tabe (Cause to continue)
Swap: Teko zepo (Put in place of)
Swear: Gugi kabo (Bad word)
Sweep: Bada (~)
Sweet: Bezi (~)
Swim: Te pi vedo (Move in water)
Swing: Bavi te (Hang and move)
Switch: Dabe (~)
Symbol: Zava (~)
Sympathy: Pake beki (Feeling together)
System: Zese (~)
Table: Zavu (~)
Tablet: Vegi za dagi (Small medicine piece)
Tackle: Vapu (~)
Tail: Pufo gi gefi dagu (Long back appendage)
Take: Tiko (~)
Tale: Katu (~)
Talent: Sigu va sake deka (Special ability)
Talk: Kasa (~)
Tall: Gefi (~)
Tank: Vepi zapi (Liquid container)
Tap: Za babi (Small touch)
Tape: Zafe (~)
Target: Gago (~)
Task: Gago (~)
Taste: Bepu (~)
Tax: Bepu (Government fee)
Taxi: Do vave zaso (Payment vehicle)
Tea: Dasu keda fapi (Hot leaf beverage)
Teach: Kate (~)
Team: Fa zegu pake vadi (Group working together)
Tear: Gedi (~)
Technique: Ketu (~)
Technology: Da gato kagi (Usage of science)
Telephone: Zasa (~)
Television: Zaku zase (Video machine)
Tell: Kadu (~)
Temperature: Do keda seku (Amount of heat)
Temporary: Tate (~)
Tend: Segu (~)
Tennis: Gese gi gego feba (Net ball sport)
Tension: Do budu (~)
Tent: Veza zazu (Cloth building)
Term: Kabo (~)
Terrible: Zu gugi (Very bad)
Territory: Vadu (~)
Terror: Do feka (~)
Test: Kade (~)
Text: Zavo (~)
Than: Deku (~)
Thank: Kafo (~)
That: Fe (~)
The: Si (~)
Theater: Do deke zazu (Acting building)
Theme: Vo zedu (Related concept)
Then: Ze (~)
Theory: Sadu do kave (Hypothetical explanation)
There: Ve (~)
Therefore: Zisa (~)
They: Ko (~)
Thick: Gefo (~)
Thin: Gifo (~)
Thing: Su (~)
Think: Kake (~)
This: Fi (~)
Though: Zesa (~)
Threat: Fa sake kiba (Something which may cause harm)
Three: Sete (~)
Throat: Fapu (Swallowing organ)
Through: Papu (~)
Throw: Bafa (~)
Thus: Zisa (~)
Ticket: Do vagi vepa (Permission paper)
Tidy: Zeka (~)
Tie: Gepi (~)
Tight: Badu (Compressing)
Tile: Vete gebe dagi (Flat cermaic piece)
Time: Tata (~)
Tin: Zapi veku veto (Container made of metal)
Tiny: Zu za (Very small)
Tip: Tedo (~)
Tire: Dabo vebu (Wheel rubber)
Tired: Fedi (~)
Title: Saka (~)
To: Di (~)
Toast: Fada fade (Cooked bread)
Today: Zi tadi (Current day)
Toe: Dage (~)
Together: Pake (~)
Toilet: Zabu (~)
Tomato: Fasa (~)
Tomorrow: Zeso tadi (Next day)
Tongue: Bepu daga (Taste organ)
Tonight: Zi tubi (Current night)
Too: Sevi (~)
Tool: Zato (~)
Tooth: Do fati veko (Biting bone)
Top: Gefa (~)
Topic: Vo zedu (The concept to which something pertains)
Total: Deto (~)
Touch: Babi (~)
Tough: Bazu (~)
Tour: Te gako vo befe (Travel for sights)
Towards: Di (~)
Towel: Kipi veza (Drying cloth)
Tower: Gefi zazu (Tall building)
Town: Vagu (~)
Toy: Fa sabo fedo (Entertainment object)
Track: Dafi (~)
Trade: Zeve zevo (Give and receive)
Tradition: Tuza gi segu detu (Old usual action)
Traffic: Desu sezu zaso (Too many vehicles)
Trailer: Va bude zaso (Pulled vehicle)
Train: Dafi zaso (Rail vehicle)
Transaction: Do vavo (~)
Tranfser: Zeve (~)
Transform: Keti (~)
Transition: Kefi pase (Change context)
Translate: Kefi kase (Change language)
Transport: Tepa (~)
Trash: Gapu (~)
Travel: Te (~)
Tray: Favu (~)
Treat: Gavo (~)
Treaty: Da vadu kafi (Country agreement)
Tree: Pevi (~)
Tremendous: Zu zu (Very big)
Trend: Kezo (~)
Trial: Do gatu (~)
Trick: Ka da kape fo tu (Cause to believe something false)
Trip: Tebo so tapi do teso (Fall while walking)
Troop: Do vapu zegu (Group of fighters)
Trouble: Gaku (~)
Truck: Tepa sabo du zaso (Object transportation vehicle)
True: Ta (~)
Trust: Kape da keve (Believe to be kind)
Try: Gatu (~)
Tube: Gepu (~)
Tune: Fesa (~)
Tunnel: Gepu zaze (Tube road)
Turn: Tedo (~)
Twice: Seta tata (Two times)
Twist: Tedo (~)
Type: Kegu (~)
Typical: Segu (~)
Ugly: Kifo (~)
Ultimate: Zito (~)
Unable: Suke (~)
Unbelievable: Suke kape (Unable to be believed)
Uncle: Zefo pezu zefa (Male sibling of parent)
Under: Puga (~)
Understand: Kadi (~)
Undertake: Sati vadi (Start work)
Unemployed: Tu zepa vado (Not having a job)
Unfair: Vuto (~)
Unfortunate: Zepa gugi saku (Having bad luck)
Unhappy: Figi (~)
Uniform: Sagi keke (Having the same quality)
Union: Do pake (~)
Unique: Sigu (~)
Unit: Seka (~)
Unite: Zeti pake (Become together)
Universal: Ta so pi seda papo (True in all places)
University: Peto do kati zese (Adult education system)
Unknown: Ta kapa (Not known)
Unless: Zetu zeko (Except if)
Unlike: Kezu (~)
Unlikely: Suzu (~)
Until: Tase (~)
Unusual: Sigu (~)
Up: Pafa (~)
Upset: Figi (~)
Urban: Vagu (Pertaining to the city)
Urge: Bazu gapa (Strong desire)
Urgent: Gaba da taki sato (Must be done soon)
Use: Gato (~)
Useful: Gaka (~)
Usual: Segu (~)
Vacation: Setu do vadi tata (Time without work)
Vague: Saki (~)
Valley: Pafa dadu (Low land)
Valuable: Gake (~)
Van: Zaze zu zaso (Large road vehicle)
Vary: Sugi (Be different)
Vast: Zu dede (Having a great extent)
Vegetable: Fapa (~)
Vehicle: Zaso (~)
Version: Gagu keta (Design state)
Very: Zu (~)
Vet: Fa peka keba pepe (Animal healing person)
Victim: Va kiba peka (Harmed person)
Victory: Do gati (~)
Video: Zaku (~)
View: Befo (~)
Village: Vagu (~)
Violence: Do vapu (~)
Virtually: Degi (~)
Virtue: Gagi do deke (Good behavior)
Virus: Dasa do pigi (Cell disease)
Visible: Sake befe (Able to be seen)
Vision: Do befe (Ability to see)
Visit: Tate pi (Temporarily be at a place)
Vital: Gake (~)
Voice: Do kasa bezo (Speech sound)
Volume: Geku (~)
Voluntary: Keko do gapa (By means of desire)
Vote: Gage (~)
Vulnerable: Sake kiba (Able to be hurt)
Wage: Vado vape (Job money)
Wait: Deta (~)
Wake: Ka da pivu (Cause to be awake)
Walk: Teso (~)
Wall: Davi (~)
Wander: Te zigi gasa (Travel without purpose)
Want: Gapa (~)
War: Do vapu (~)
Wardrobe: Zaza gi zapi zaga (Clothing container furniture)
Warm: Keda (~)
Warn: Kavi (~)
Wash: Ka da kedu (Cause to become clean)
Waste: Gato zigi gasa (Use with no purpose)
Watch: Befo (~)
Water: Vedo (~)
Wave: Gebu (~)
Way: Ketu (~)
We: Bi (~)
Weak: Buzu (~)
Wealth: Dega vape (Extra money)
Weapon: Do vapu zato (Fighting tool)
Wear: Zazo (~)
Weather: Kepe (~)
Web: Zadu (~)
Website: Zadu papo (Internet place)
Wedding: Zeta (~)
Week: Tade (~)
Weight: Babo (~)
Weird: Sigu (~)
Welcome: Kafe (~)
Well: Gagi (~)
West: Pude (~)
Wet: Kepi (~)
What: Sazi su (Which thing)
Wheel: Dado (~)
Whether: Sase (~)
Which: Sazi (~)
While: Tapi (~)
Whisper: Biva kasa (Speak quietly)
White: Bege (~)
Whole: Deto (~)
Wide: Gefe (~)
Wife: Pezi zete (Female spouse)
Wild: Kedi (~)
Will: Ba (~)
Win: Gati (~)
Wind: Te vezo (Moving air)
Window: Dabi (~)
Wine: Fasi fapo (Fruit alcohol)
Wing: Do tepe dagu (Flying appendage)
Winter: Kida tado (Cold season)
Wipe: Baza (~)
Wire: Zafi (~)
Wise: Kapa fo sezu (Knowing a lot)
Wish: Gapa (~)
With: Zegi (~)
Withdraw: Tiko de (Take from)
Witness: Beki (~)
Woman: Pezi peka (Female person)
Wonder: Gapa da kapa (Want to know)
Wonderful: Zu gagi (Very good)
Wood: Veka (~)
Wool: Pege dada (Sheep hair)
Word: Kabo (~)
Work: Vadi (~)
World: Paso (~)
Worry: Fepa (~)
Worse: Deko gugi (More bad)
Worth: Do gake seku (Amount of importance)
Would: Sadu (~)
Wound: Da geze gedi (Breaking of skin)
Wrap: Zapu (~)
Write: Zabi (~)
Wrong: Tu (~)
Yard: Dadu paki zazu (Land near building)
Yeah: Ta (~)
Year: Tadu (~)
Yellow: Bete (~)
Yep: Ta (~)
Yes: Ta (~)
Yesterday: Ziso tadi (Previous day)
Yet: Taba (~)
You: Ke (~)
Young: Taza (~)
Youth: Fo taza (~)
Zone: Geka (~)


